6 6 3 3
1 1 4 1 1 1
1 1 0 1 1 1
1 1 2 0 2 4
4 0 2 0 1 1
1 1 1 2 1 1
1 1 1 4 1 1
5 6 2 3
0 4 4 2 0
0 1 0 2 0
0 1 0 1 0
0 2 0 1 0
4 2 0 0 0
4 1 1 1 1
7 6 2 0
1 0 0 4 4 4 1
1 0 0 0 1 1 1
1 1 2 0 0 0 0
0 0 0 1 2 1 0
0 2 0 1 0 0 0
0 0 0 1 1 1 1
7 7 0 0
0 0 0 0 1 1 1
0 2 2 1 0 1 1
0 2 0 1 0 1 4
1 1 0 1 1 1 4
1 1 0 0 0 0 4
1 0 0 0 1 0 0
1 0 0 0 1 1 1
6 6 4 5
0 0 0 1 0 0
0 1 0 1 2 4
0 0 0 0 2 4
0 1 0 1 2 4
0 0 0 1 0 0
1 1 1 1 0 0
6 6 1 0
1 0 0 1 1 1
1 0 2 0 0 1
1 1 0 1 0 1
4 1 0 1 0 0
4 2 0 0 1 0
4 0 0 0 2 0
8 5 1 2
1 0 0 0 0 0 1 1
1 2 1 1 1 0 0 0
0 0 0 2 0 0 2 0
0 4 4 1 0 2 0 1
1 4 4 1 0 0 0 1
7 5 2 4
0 0 0 0 0 1 1
0 2 2 2 1 1 1
0 0 1 4 4 1 1
1 0 0 4 4 2 0
1 0 0 0 0 0 0
8 6 7 0
1 1 1 0 0 1 0 0
1 1 0 0 0 1 0 0
1 1 2 0 2 0 2 0
1 1 0 2 1 1 0 0
1 1 0 2 0 1 0 0
4 4 4 4 4 0 0 1
13 10 6 9
1 1 1 1 1 1 0 0 0 0 0 0 0
1 1 1 1 1 1 0 1 0 1 0 1 0
1 1 1 1 1 1 0 0 2 0 2 1 0
1 1 1 1 1 1 0 0 0 2 0 0 0
4 4 1 0 0 1 1 0 2 0 2 1 0
4 4 0 0 0 1 1 0 2 0 2 0 0
4 4 1 0 0 1 1 0 1 1 1 1 1
4 4 1 0 1 0 2 0 2 0 1 1 1
4 4 0 0 0 0 0 2 0 0 1 1 1
0 0 1 1 1 0 0 0 1 1 1 1 1
12 8 5 3
4 4 1 1 1 1 1 1 1 1 4 4
6 4 6 4 4 4 4 4 6 4 6 4
0 2 0 2 0 2 0 2 0 2 0 2
2 0 2 0 2 0 2 0 2 0 2 0
0 2 0 2 0 2 0 2 0 2 0 2
2 0 2 0 2 0 2 0 2 0 2 0
4 6 4 6 4 4 4 4 4 6 4 6
4 4 1 1 1 1 1 1 1 1 4 4
14 11 1 5
1 1 1 1 0 0 1 1 1 1 1 1 1 1
0 0 2 0 2 0 1 1 1 1 1 1 1 1
0 0 0 2 0 0 1 1 1 6 4 6 4 6
1 0 2 0 2 0 1 1 1 4 6 4 6 4
1 2 0 2 0 0 1 0 0 6 4 6 4 6
1 0 2 0 2 0 0 0 0 4 6 4 6 1
1 2 0 2 0 0 1 0 0 6 4 6 4 6
1 0 2 0 2 0 1 1 1 4 6 4 6 4
0 0 0 2 0 0 1 1 1 6 4 6 4 6
0 0 2 0 2 0 1 1 1 1 1 1 1 1
1 1 1 1 0 0 1 1 1 1 1 1 1 1
14 11 7 0
1 1 1 4 4 4 1 0 1 1 0 0 1 1
1 4 4 4 4 4 1 2 0 0 2 0 0 0
1 4 4 4 4 4 1 0 0 1 2 2 0 0
1 4 4 4 4 4 0 2 0 1 0 2 0 0
1 4 4 0 4 4 1 2 1 0 0 1 1 1
1 1 1 1 0 1 1 0 0 0 0 0 1 1
0 2 0 2 2 1 0 0 1 1 1 0 1 1
0 0 2 0 0 1 2 0 2 0 2 0 1 1
0 2 0 2 0 0 2 2 2 0 0 0 1 1
0 0 0 0 0 1 2 0 2 0 2 0 1 1
1 1 1 1 1 1 0 0 0 0 0 0 1 1